########################
#......................#
#..####........####....#
#..#...............#...#
#..#...............#...#
#..#....#####......#...#
#..#....#...#......#...#
#..#....#...#......#...#
#..#....#...#......#...#
#..#....#####......#...#
#..#...............#...#
#..#...............#...#
#..####........#####...#
#......................#
#......................#
#......................#
#......................#
########################